width:17
height:17
mazeX:0
mazeY:3
starX:0
starY:-6
.......#...#..##P
.#####.#.#...##..
.#...#.#.######.#
.#.#...#..#...#..
.#.######.#.#S##.
.......#..#.#....
#####.##.##.#####
....#..#..S......
.##.##.###.###.##
..#...S....#.....
#S#.##.#####.###.
.......#........S
.##.#..#.######.#
..#.#.##.#....#..
..#.#..#.#.#####.
.##.##.#.#.#...#.
@.......S....#...