width:15
height:15
mazeX:0
mazeY:0
starX:0
starY:-6
@#.......S#....
.#.######.#.##.
...#....#.#.#P.
####S#.##.#.###
.....#....#...S
.#############.
.#...#S..#...#.
...#.#.#...#.#.
####S#.#####.#.
.....#..##.#.S.
.#####.#.S.####
.#.S.#.#.#.....
.#.#.#...#####.
.#.#.#####.S.#.
...#.......#...