width:15
height:15
mazeX:4
mazeY:0
starX:0
starY:-6
....#......#...
..#.#....#.#.#.
.##.####.#.#@#.
S#.......#.###.
.######..#..P#.
...#...#######.
.#...#...#...#.
########.#.#S#.
.....#...#.#...
#.#.#..###.####
..#...####.#...
.#########...#.
.#...#...#####.
...#.S.#.#...#.
.#...#.....#...