width:15
height:15
mazeX:0
mazeY:0
starX:0
starY:-6
.#..S..#..S..#.
#..#SS#..#SS#S.
..#..#..#..#.SS
@#..#.S#..#..#.
#..#..#..#..#..
..#..#..#..#..#
.#..#SS#..#..#.
SS.#..#SS#..#S.
.S#..#..#SS#.SS
.#..#..#..#..#.
#..#..#..#..#..
..#..#..#SS#..#
.#..#..#..#SS#P
SS.#SS#..#..#..
.S#..S..#.....#