width:17
height:17
mazeX:6
mazeY:3
starX:0
starY:-6
.......#P#...#...
.#####.#.#.#.#S#.
.#...#S#.#.#.#.#.
.#.#.#.#.#.#.#.#.
P#S#...#.#.#.#.#.
##.#####.#.#S#.#.
.......#.#.#...#@
######S#.#S######
...#...#.#.#.S..#
.#.#.#.#.#.#.##.#
.#...#.#.#....#..
.#######.#######.
...#...#.#.....#.
S###.###.#.###S#.
...#...###.....#.
.#.#.#S#.#.#####S
.#...#...........