width:17
height:17
mazeX:0
mazeY:6
starX:0
starY:-6
.....#....S###.S.
P#.###.###.###.#.
##.#...#...#...#.
...#S###.###.###.
.###.#...#...#...
.#...#.###.###.##
.#.###.#...#.S.#.
S..#...#.###.###.
.###.###.#...#.S.
.#...#...#.###.#.
.#S###.###.#...#.
##.#...#..S#.###.
...#.###.###.#...
.###.#.#.....#.##
.#@..#.#######S##
S#####...#...#.##
.......#.S.#...##